1111111111111111111111
1000000000000000000001
100C000000000000000001
10011000000000E0000001
10000000C000000000C001
100000001100000X001101
10X0000000000C00000001
1000C0000000011X000001
100011000C000000C00001
1000000001100000110001
1000000000000000000001
100P000000000000000001
1001100000000000011001
1000000000000000000001
1000000000000000000001
1111111111111111111111