1111111111111111111111
1000000000000000000001
100C000000000000000001
10011000000000E0000001
10000000C000000000C001
1000000011000000001101
10X0000000000C00000001
1000C00000000110X00001
100011000C000000C00001
10000X0001100000110001
1000000000000000000001
100P000000000000000001
1001100000000000011001
1000000110001100000001
1000000000000000000001
1111111111111111111111