1111111111111111111111
1000000000000000000001
1000000000000000000001
10011000000000E0000001
1000000000000000000001
1000000011000000001101
1000000000000000000001
1000000000000110000001
1000110000000000000001
1000000001100000110001
1000000000000000000001
100P000000000000000001
1001100000000000011001
1000000000000000000001
1000000000000000000001
1111111111111111111111